"filename", "language", "Batch", "WLA-DX", "Lua", "comment", "blank", "total"
"c:\Users\stephane\Documents\Programmation\Alice\projets\GameJam-Alice\levels\main.lua", "Lua", 0, 0, 647, 57, 110, 814
"c:\Users\stephane\Documents\Programmation\Alice\projets\GameJam-Alice\sources\automaticMove.asm", "WLA-DX", 0, 61, 0, 11, 18, 90
"c:\Users\stephane\Documents\Programmation\Alice\projets\GameJam-Alice\sources\constante.asm", "WLA-DX", 0, 24, 0, 1, 1, 26
"c:\Users\stephane\Documents\Programmation\Alice\projets\GameJam-Alice\sources\dataGFX.asm", "WLA-DX", 0, 47, 0, 17, 5, 69
"c:\Users\stephane\Documents\Programmation\Alice\projets\GameJam-Alice\sources\dataLevels.asm", "WLA-DX", 0, 4, 0, 0, 2, 6
"c:\Users\stephane\Documents\Programmation\Alice\projets\GameJam-Alice\sources\drawLogo.asm", "WLA-DX", 0, 38, 0, 1, 8, 47
"c:\Users\stephane\Documents\Programmation\Alice\projets\GameJam-Alice\sources\ghost.asm", "WLA-DX", 0, 352, 0, 28, 80, 460
"c:\Users\stephane\Documents\Programmation\Alice\projets\GameJam-Alice\sources\interrup.asm", "WLA-DX", 0, 122, 0, 23, 43, 188
"c:\Users\stephane\Documents\Programmation\Alice\projets\GameJam-Alice\sources\key.asm", "WLA-DX", 0, 94, 0, 14, 16, 124
"c:\Users\stephane\Documents\Programmation\Alice\projets\GameJam-Alice\sources\keyManager.asm", "WLA-DX", 0, 123, 0, 29, 28, 180
"c:\Users\stephane\Documents\Programmation\Alice\projets\GameJam-Alice\sources\levelManager\level.asm", "WLA-DX", 0, 378, 0, 46, 95, 519
"c:\Users\stephane\Documents\Programmation\Alice\projets\GameJam-Alice\sources\main.asm", "WLA-DX", 0, 288, 0, 33, 77, 398
"c:\Users\stephane\Documents\Programmation\Alice\projets\GameJam-Alice\sources\main2.asm", "WLA-DX", 0, 28, 0, 4, 15, 47
"c:\Users\stephane\Documents\Programmation\Alice\projets\GameJam-Alice\sources\math.asm", "WLA-DX", 0, 12, 0, 3, 3, 18
"c:\Users\stephane\Documents\Programmation\Alice\projets\GameJam-Alice\sources\sceneManager\sceneManager.asm", "WLA-DX", 0, 33, 0, 5, 10, 48
"c:\Users\stephane\Documents\Programmation\Alice\projets\GameJam-Alice\sources\sceneManager\scenes\sceneGame.asm", "WLA-DX", 0, 461, 0, 66, 99, 626
"c:\Users\stephane\Documents\Programmation\Alice\projets\GameJam-Alice\sources\sceneManager\scenes\sceneGameOver.asm", "WLA-DX", 0, 64, 0, 21, 20, 105
"c:\Users\stephane\Documents\Programmation\Alice\projets\GameJam-Alice\sources\sceneManager\scenes\sceneMenu.asm", "WLA-DX", 0, 159, 0, 39, 61, 259
"c:\Users\stephane\Documents\Programmation\Alice\projets\GameJam-Alice\sources\sceneManager\scenes\sceneNextLevel.asm", "WLA-DX", 0, 63, 0, 21, 25, 109
"c:\Users\stephane\Documents\Programmation\Alice\projets\GameJam-Alice\sources\sceneManager\scenes\sceneNoBonus.asm", "WLA-DX", 0, 109, 0, 15, 40, 164
"c:\Users\stephane\Documents\Programmation\Alice\projets\GameJam-Alice\sources\sceneManager\scenes\sceneSelectLevel.asm", "WLA-DX", 0, 29, 0, 4, 6, 39
"c:\Users\stephane\Documents\Programmation\Alice\projets\GameJam-Alice\sources\sceneManager\scenes\sceneVictory.asm", "WLA-DX", 0, 113, 0, 12, 29, 154
"c:\Users\stephane\Documents\Programmation\Alice\projets\GameJam-Alice\sources\sprite.asm", "WLA-DX", 0, 224, 0, 62, 43, 329
"c:\Users\stephane\Documents\Programmation\Alice\projets\GameJam-Alice\sources\updateKey.asm", "WLA-DX", 0, 139, 0, 8, 31, 178
"c:\Users\stephane\Documents\Programmation\Alice\projets\GameJam-Alice\sources\utils.asm", "WLA-DX", 0, 48, 0, 19, 21, 88
"c:\Users\stephane\Documents\Programmation\Alice\projets\GameJam-Alice\sprites\main.lua", "Lua", 0, 0, 124, 12, 23, 159
"c:\Users\stephane\Documents\Programmation\Alice\projets\GameJam-Alice\start.bat", "Batch", 1, 0, 0, 1, 2, 4
"Total", "-", 1, 3013, 771, 552, 911, 5248